,Segment,nTotal,nUrban,nSuburb,dTotal,sumTotal,ratioTotal,dUrban,sumUrban,ratioUrban,dSuburb,sumSuburb,ratioSuburb,Year
0,775,640,461,179,0,88639,0.00722029806292941,0,30179,0.015275522714470326,0,58460,0.0030619226821758465,2023
1,774,770,552,218,130,88639,0.008686921106961946,91,30179,0.018290864508433015,39,58460,0.0037290455011974,2023
2,773,939,671,268,169,88639,0.010593531064204244,119,30179,0.02223400377746115,50,58460,0.004584331166609648,2023
3,772,1110,780,330,171,88639,0.012522704452893196,109,30179,0.02584578680539448,62,58460,0.005644885391720835,2023
4,771,1297,911,386,187,88639,0.014632385293155383,131,30179,0.03018655356373637,56,58460,0.006602805336982552,2023
5,770,1477,1039,438,180,88639,0.016663094123354278,128,30179,0.034427913449749825,52,58460,0.00749230242901129,2023
6,769,1705,1181,524,228,88639,0.01923532530827288,142,30179,0.039133172073296,86,58460,0.008963393773520355,2023
7,768,1917,1317,600,212,88639,0.02162704904161825,136,30179,0.043639616952185295,76,58460,0.010263427984946972,2023
8,767,2136,1453,683,219,88639,0.024097744785026905,136,30179,0.04814606183107459,83,58460,0.011683202189531304,2023
9,766,2406,1630,776,270,88639,0.02714380803032525,177,30179,0.054011067298452564,93,58460,0.013274033527198085,2023
10,765,2682,1800,882,276,88639,0.03025756156996356,170,30179,0.05964412339706418,106,58460,0.01508723913787205,2023
11,764,2926,1936,990,244,88639,0.0330103002064554,136,30179,0.06415056827595347,108,58460,0.016934656175162505,2023
12,763,3250,2129,1121,324,88639,0.03666557610081341,193,30179,0.07054574372908314,131,58460,0.01917550461854259,2023
13,762,3548,2317,1231,298,88639,0.04002752738636492,188,30179,0.0767752410616654,110,58460,0.02105713308244954,2023
14,761,3854,2481,1373,306,88639,0.043479732397703044,164,30179,0.08220948341562014,142,58460,0.02348614437222032,2023
15,760,4258,2712,1546,404,88639,0.04803754554992723,231,30179,0.08986381258491004,173,58460,0.0264454327745467,2023
16,759,4608,2903,1705,350,88639,0.05198614605309176,191,30179,0.09619271678982073,159,58460,0.029165241190557648,2023
17,758,4957,3122,1835,349,88639,0.05592346484053295,219,30179,0.10344941846979688,130,58460,0.03138898392062949,2023
18,757,5350,3328,2022,393,88639,0.06035717911980054,206,30179,0.11027535703634977,187,58460,0.034587752309271295,2023
19,756,5701,3522,2179,351,88639,0.06431706133868839,194,30179,0.11670366811358891,157,58460,0.037273349298665756,2023
20,755,6100,3723,2377,399,88639,0.06881846591229594,201,30179,0.12336392855959442,198,58460,0.04066028053369825,2023
21,754,6517,3944,2573,417,88639,0.07352294136892339,221,30179,0.13068690148778953,196,58460,0.044013000342114264,2023
22,753,6954,4173,2781,437,88639,0.07845305114001737,229,30179,0.13827495940886048,208,58460,0.04757098871022922,2023
23,752,7399,4411,2988,445,88639,0.08347341463689797,238,30179,0.14616123794691674,207,58460,0.05111187136503592,2023
24,751,7828,4629,3199,429,88639,0.08831327068220535,218,30179,0.1533848040027834,211,58460,0.05472117687307561,2023
25,750,8274,4854,3420,446,88639,0.09334491589480928,225,30179,0.16084031942741642,221,58460,0.058501539514197745,2023
26,749,8763,5106,3657,489,88639,0.09886167488351628,252,30179,0.1691904967030054,237,58460,0.0625555935682518,2023
27,748,9227,5345,3882,464,88639,0.10409639097914011,239,30179,0.17710991086517114,225,58460,0.0664043790626069,2023
28,747,9682,5561,4121,455,88639,0.10922957163325399,216,30179,0.18426720567281885,239,58460,0.07049264454327746,2023
29,746,10150,5783,4367,468,88639,0.11450941459177112,222,30179,0.19162331422512344,246,58460,0.07470065001710571,2023
30,745,10597,6017,4580,447,88639,0.11955234152009837,234,30179,0.19937705026674177,213,58460,0.07834416695176188,2023
31,744,11049,6263,4786,452,88639,0.12465167702704227,246,30179,0.20752841379767387,206,58460,0.08186794389326035,2023
32,743,11516,6503,5013,467,88639,0.12992023826983606,240,30179,0.2154809635839491,227,58460,0.08575094081423196,2023
33,742,11982,6705,5277,466,88639,0.13517751779690657,202,30179,0.2221743596540641,264,58460,0.09026684912760861,2023
34,741,12452,6929,5523,470,88639,0.14047992418687033,224,30179,0.22959673945458764,246,58460,0.09447485460143688,2023
35,740,12958,7161,5797,506,88639,0.1461884723428739,232,30179,0.23728420424798702,274,58460,0.09916182004789599,2023
36,739,13484,7403,6081,526,88639,0.15212265481334403,242,30179,0.24530302528248119,284,58460,0.10401984262743756,2023
37,738,14016,7637,6379,532,88639,0.1581245275781541,234,30179,0.25305676132409954,298,58460,0.10911734519329457,2023
38,737,14523,7858,6665,507,88639,0.163844357449881,221,30179,0.26037973425229466,286,58460,0.11400957919945262,2023
39,736,15065,8111,6954,542,88639,0.16995904737192433,253,30179,0.2687630471519931,289,58460,0.11895313034553541,2023
40,735,15577,8369,7208,512,88639,0.17573528582226786,258,30179,0.277312038172239,254,58460,0.12329798152582963,2023
41,734,16143,8611,7532,566,88639,0.18212073692167105,242,30179,0.2853308592067332,324,58460,0.128840232637701,2023
42,733,16669,8834,7835,526,88639,0.18805491939214117,223,30179,0.29272010338314725,303,58460,0.1340232637700992,2023
43,732,17217,9073,8144,548,88639,0.19423729960852446,239,30179,0.300639517545313,309,58460,0.1393089291823469,2023
44,731,17731,9299,8432,514,88639,0.20003610149031464,226,30179,0.30812816859405545,288,58460,0.14423537461512145,2023
45,730,18276,9521,8755,545,88639,0.20618463655952798,222,30179,0.31548427714636007,323,58460,0.14976052001368456,2023
46,729,18773,9730,9043,497,88639,0.21179164927402158,209,30179,0.3224096225852414,288,58460,0.15468696544645913,2023
47,728,19347,9959,9388,574,88639,0.2182673540992114,229,30179,0.32999768050631234,345,58460,0.16058843653780364,2023
48,727,19923,10205,9718,576,88639,0.22476562235584788,246,30179,0.33814904403724444,330,58460,0.16623332192952447,2023
49,726,20482,10431,10051,559,88639,0.23107210144518778,226,30179,0.34563769508598696,333,58460,0.17192952446117002,2023
50,725,21054,10644,10410,572,88639,0.23752524283893095,213,30179,0.3526955830213062,359,58460,0.17807047553882996,2023
51,724,21638,10896,10742,584,88639,0.24411376482135402,252,30179,0.36104576029689517,332,58460,0.1837495723571673,2023
52,723,22196,11116,11080,558,88639,0.2504089621949706,220,30179,0.36833559760098084,338,58460,0.1895313034553541,2023
53,722,22720,11327,11393,524,88639,0.25632058123399404,211,30179,0.37532721428808113,313,58460,0.19488539172083477,2023
54,721,23234,11533,11701,514,88639,0.26211938311578425,206,30179,0.382153152854634,308,58460,0.2001539514197742,2023
55,720,23809,11748,12061,575,88639,0.2686063696566974,215,30179,0.38927731203817223,360,58460,0.2063120082107424,2023
56,719,24348,11937,12411,539,88639,0.27468721443157074,189,30179,0.395539944994864,350,58460,0.21229900786862813,2023
57,718,24885,12152,12733,537,88639,0.28074549577499747,215,30179,0.4026641041784022,322,58460,0.217807047553883,2023
58,717,25465,12378,13087,580,88639,0.28728889089452725,226,30179,0.4101527552271447,354,58460,0.2238624700650017,2023
59,716,26048,12599,13449,583,88639,0.293866131161227,221,30179,0.4174757281553398,362,58460,0.23005473828258638,2023
60,715,26613,12804,13809,565,88639,0.30024030054490686,205,30179,0.42426853109778323,360,58460,0.23621279507355455,2023
61,714,27138,13014,14124,525,88639,0.30616320129965363,210,30179,0.431227012160774,315,58460,0.24160109476565172,2023
62,713,27697,13227,14470,559,88639,0.31246968038899353,213,30179,0.43828490009609333,346,58460,0.2475196715703045,2023
63,712,28220,13434,14786,523,88639,0.3183700177122937,207,30179,0.4451439742867557,316,58460,0.2529250769757099,2023
64,711,28764,13631,15133,544,88639,0.3245072710657837,197,30179,0.45167169223632325,347,58460,0.2588607594936709,2023
65,710,29286,13844,15442,522,88639,0.3303963266733605,213,30179,0.45872958017164256,309,58460,0.26414642490591855,2023
66,709,29834,14030,15804,548,88639,0.3365787068897438,186,30179,0.4648928062560058,362,58460,0.2703386931235032,2023
67,708,30363,14212,16151,529,88639,0.3425467345073839,182,30179,0.47092348984393123,347,58460,0.27627437564146423,2023
68,707,30927,14424,16503,564,88639,0.34890962217534044,212,30179,0.477948242155141,352,58460,0.2822955867259665,2023
69,706,31490,14645,16845,563,88639,0.35526122812757366,221,30179,0.4852712150833361,342,58460,0.28814574067738624,2023
70,705,32035,14828,17207,545,88639,0.36140976319678697,183,30179,0.49133503429537095,362,58460,0.2943380088949709,2023
71,704,32591,15025,17566,556,88639,0.3676823971389569,197,30179,0.49786275224493853,359,58460,0.30047895997263085,2023
72,703,33153,15239,17914,562,88639,0.37402272137546677,214,30179,0.5049537758043673,348,58460,0.3064317482039001,2023
73,702,33668,15402,18266,515,88639,0.3798328049729803,163,30179,0.5103548825342126,352,58460,0.31245295928840233,2023
74,701,34178,15568,18610,510,88639,0.3855864799918772,166,30179,0.5158553961363862,344,58460,0.3183373246664386,2023
75,700,34730,15773,18957,552,88639,0.3918139870711538,205,30179,0.5226481990788296,347,58460,0.3242730071843996,2023
76,699,35272,15962,19310,542,88639,0.3979286769931971,189,30179,0.5289108320355214,353,58460,0.3303113239822101,2023
77,698,35751,16107,19644,479,88639,0.40333261882467086,145,30179,0.533715497531396,334,58460,0.3360246322271639,2023
78,697,36263,16297,19966,512,88639,0.4091088572750144,190,30179,0.5400112661121972,322,58460,0.34153267191241876,2023
79,696,36794,16482,20312,531,88639,0.4150994483241011,185,30179,0.546141356572451,346,58460,0.3474512487170715,2023
80,695,37292,16623,20669,498,88639,0.42071774275431806,141,30179,0.5508134795718878,357,58460,0.353557988368115,2023
81,694,37777,16785,20992,485,88639,0.42618937488013175,162,30179,0.5561814506776235,323,58460,0.35908313376667805,2023
82,693,38265,16945,21320,488,88639,0.4316948521531154,160,30179,0.5614831505351403,328,58460,0.3646938077317824,2023
83,692,38747,17102,21645,482,88639,0.43713263913175915,157,30179,0.5666854435203287,325,58460,0.370253164556962,2023
84,691,39263,17260,22003,516,88639,0.442954004444996,158,30179,0.5719208721296266,358,58460,0.37637700992131373,2023
85,690,39781,17443,22338,518,88639,0.4487979331896795,183,30179,0.5779846913416614,335,58460,0.3821074238795758,2023
86,689,40263,17599,22664,482,88639,0.4542357201683232,156,30179,0.5831538487027403,326,58460,0.3876838864180636,2023
87,688,40761,17761,23000,498,88639,0.45985401459854014,162,30179,0.5885218198084761,336,58460,0.39343140608963395,2023
88,687,41222,17902,23320,461,88639,0.465054885546994,141,30179,0.5931939428079128,320,58460,0.3989052343482723,2023
89,686,41718,18077,23641,496,88639,0.4706506165457643,175,30179,0.5989926770270718,321,58460,0.40439616832021896,2023
90,685,42165,18220,23945,447,88639,0.47569354347409154,143,30179,0.6037310712747275,304,58460,0.40959630516592543,2023
91,684,42622,18366,24256,457,88639,0.48084928755965206,146,30179,0.6085688723947116,311,58460,0.4149161820047896,2023
92,683,43080,18507,24573,458,88639,0.4860163133609359,141,30179,0.6132409953941482,317,58460,0.42033869312350325,2023
93,682,43519,18645,24874,439,88639,0.4909689865634766,138,30179,0.6178137115212565,301,58460,0.425487512829285,2023
94,681,43949,18777,25172,430,88639,0.4958201243245073,132,30179,0.6221876139037079,298,58460,0.430585015395142,2023
95,680,44411,18914,25497,462,88639,0.5010322769886845,137,30179,0.6267271944067067,325,58460,0.4361443722203216,2023
96,679,44860,19053,25807,449,88639,0.5060977673484583,139,30179,0.6313330461579244,310,58460,0.44144714334587754,2023
97,678,45319,19201,26118,459,88639,0.5112760748654656,148,30179,0.6362371185261274,311,58460,0.4467670201847417,2023
98,677,45730,19345,26385,411,88639,0.515912860027753,144,30179,0.6410086483978926,267,58460,0.4513342456380431,2023
99,676,46126,19472,26654,396,88639,0.5203804194541906,127,30179,0.6452168726597965,269,58460,0.455935682517961,2023
100,675,46527,19590,26937,401,88639,0.5249043874592448,118,30179,0.6491268763047152,283,58460,0.4607765993841943,2023
101,674,46957,19723,27234,430,88639,0.5297555252202755,133,30179,0.653533914311276,297,58460,0.4658569962367431,2023
102,673,47360,19833,27527,403,88639,0.5343020566567763,110,30179,0.6571788329633189,293,58460,0.47086897023605884,2023
103,672,47815,19959,27856,455,88639,0.5394352373108903,126,30179,0.6613539216011134,329,58460,0.47649674991447144,2023
104,671,48276,20112,28164,461,88639,0.544636108259344,153,30179,0.6664236720898639,308,58460,0.48176530961341085,2023
105,670,48676,20226,28450,400,88639,0.5491487945486749,114,30179,0.6702011332383445,286,58460,0.4866575436195689,2023
106,669,49084,20358,28726,408,88639,0.5537517345637925,132,30179,0.6745750356207959,276,58460,0.4913787204926445,2023
107,668,49483,20454,29029,399,88639,0.5582531391374,96,30179,0.677756055535306,303,58460,0.4965617516250428,2023
108,667,49888,20554,29334,405,88639,0.5628222340053476,100,30179,0.681069617946254,305,58460,0.5017789941840575,2023
109,666,50295,20686,29609,407,88639,0.5674138923047417,132,30179,0.6854435203287054,275,58460,0.5064830653438248,2023
110,665,50702,20794,29908,407,88639,0.5720055506041358,108,30179,0.6890221677325292,299,58460,0.51159767362299,2023
111,664,51095,20892,30203,393,88639,0.5764392648834035,98,30179,0.6922694588952583,295,58460,0.5166438590489223,2023
112,663,51497,21004,30493,402,88639,0.580974514604181,112,30179,0.69598064879552,290,58460,0.5216045159083134,2023
113,662,51912,21125,30787,415,88639,0.5856564266293618,121,30179,0.6999900593127671,294,58460,0.5266335956209374,2023
114,661,52287,21243,31044,375,88639,0.5898870700256095,118,30179,0.7039000629576858,257,58460,0.5310297639411563,2023
115,660,52685,21358,31327,398,88639,0.5943771928834938,115,30179,0.707710659730276,283,58460,0.5358706808073896,2023
116,659,53066,21464,31602,381,88639,0.5986755265740814,106,30179,0.7112230358858809,275,58460,0.540574751967157,2023
117,658,53423,21577,31846,357,88639,0.6027030990873092,113,30179,0.7149673614102522,244,58460,0.5447485460143688,2023
118,657,53796,21676,32120,373,88639,0.6069111790521102,99,30179,0.7182477881970907,274,58460,0.5494355114608279,2023
119,656,54161,21786,32375,365,88639,0.6110290052911247,110,30179,0.7218927068491335,255,58460,0.5537974683544303,2023
120,655,54503,21876,32627,342,88639,0.6148873520685025,90,30179,0.7248749130189868,252,58460,0.5581081081081081,2023
121,654,54858,21972,32886,355,88639,0.6188923611502838,96,30179,0.7280559329334968,259,58460,0.5625384878549435,2023
122,653,55235,22073,33162,377,88639,0.623145567977978,101,30179,0.7314026309685543,276,58460,0.5672596647280191,2023
123,652,55612,22187,33425,377,88639,0.6273987748056724,114,30179,0.7351800921170351,263,58460,0.5717584673280875,2023
124,651,55954,22269,33685,342,88639,0.6312571215830504,82,30179,0.7378972132940124,260,58460,0.5762059527882313,2023
125,650,56299,22350,33949,345,88639,0.6351493135075983,81,30179,0.7405811988468802,264,58460,0.580721861101608,2023
126,649,56638,22446,34192,339,88639,0.6389738151378062,96,30179,0.7437622187613904,243,58460,0.5848785494355114,2023
127,648,56986,22542,34444,348,88639,0.6428998522095241,96,30179,0.7469432386759005,252,58460,0.5891891891891892,2023
128,647,57293,22622,34671,307,88639,0.6463633389365855,80,30179,0.7495940886046588,227,58460,0.5930721861101608,2023
129,646,57615,22718,34897,322,88639,0.6499960513994968,96,30179,0.752775108519169,226,58460,0.5969380773178241,2023
130,645,57929,22806,35123,314,88639,0.6535385101366216,88,30179,0.7556910434408032,226,58460,0.6008039685254876,2023
131,644,58264,22897,35367,335,88639,0.6573178849039362,91,30179,0.7587063852347659,244,58460,0.6049777625726993,2023
132,643,58584,23002,35582,320,88639,0.6609280339354009,105,30179,0.7621856257662613,215,58460,0.608655490933972,2023
133,642,58931,23105,35826,347,88639,0.6648427892913954,103,30179,0.7655985950495378,244,58460,0.6128292849811837,2023
134,641,59253,23194,36059,322,88639,0.6684755017543068,89,30179,0.7685476655952815,233,58460,0.6168149161820048,2023
135,640,59568,23282,36286,315,88639,0.6720292422071549,88,30179,0.7714636005169158,227,58460,0.6206979131029764,2023
136,639,59892,23372,36520,324,88639,0.6756845181015129,90,30179,0.774445806686769,234,58460,0.6247006500171057,2023
137,638,60226,23456,36770,334,88639,0.6794526111531042,84,30179,0.7772291991119653,250,58460,0.6289770783441669,2023
138,637,60509,23521,36988,283,88639,0.6826453367028058,65,30179,0.7793830146790814,218,58460,0.6327061238453644,2023
139,636,60800,23595,37205,291,88639,0.685928315978294,74,30179,0.7818350508631831,217,58460,0.6364180636332535,2023
140,635,61148,23696,37452,348,88639,0.6898543530500119,101,30179,0.7851817488982406,247,58460,0.64064317482039,2023
141,634,61446,23778,37668,298,88639,0.6932163043355634,82,30179,0.7878988700752179,216,58460,0.644338008894971,2023
142,633,61765,23870,37895,319,88639,0.6968151716513047,92,30179,0.79094734749329,227,58460,0.6482210058159426,2023
143,632,62055,23932,38123,290,88639,0.7000868692110697,62,30179,0.7930017561880778,228,58460,0.6521211084502224,2023
144,631,62358,23998,38360,303,88639,0.7035052290752377,66,30179,0.7951887073793035,237,58460,0.6561751625042764,2023
145,630,62631,24076,38555,273,88639,0.7065851374677061,78,30179,0.797773286059843,195,58460,0.6595107765993842,2023
146,629,62939,24162,38777,308,88639,0.7100599059104908,86,30179,0.8006229497332582,222,58460,0.6633082449538146,2023
147,628,63229,24231,38998,290,88639,0.7133316034702557,69,30179,0.8029093077968124,221,58460,0.6670886075949367,2023
148,627,63509,24302,39207,280,88639,0.7164904838727874,71,30179,0.8052619371085854,209,58460,0.6706637016763599,2023
149,626,63786,24380,39406,277,88639,0.719615519128149,78,30179,0.8078465157891249,199,58460,0.6740677386247006,2023
150,625,64102,24450,39652,316,88639,0.7231805412967204,70,30179,0.8101660094767885,246,58460,0.6782757440985289,2023
151,624,64383,24513,39870,281,88639,0.7263507034149753,63,30179,0.8122535537956858,218,58460,0.6820047895997263,2023
152,623,64687,24582,40105,304,88639,0.7297803449948668,69,30179,0.8145399118592399,235,58460,0.6860246322271639,2023
153,622,64943,24638,40305,256,88639,0.7326684642200386,56,30179,0.8163955068093708,200,58460,0.6894457748888129,2023
154,621,65237,24708,40529,294,88639,0.7359852886426967,70,30179,0.8187150004970344,224,58460,0.6932774546698597,2023
155,620,65545,24790,40755,308,88639,0.7394600570854816,82,30179,0.8214321216740117,226,58460,0.6971433458775231,2023
156,619,65795,24861,40934,250,88639,0.7422804860163134,71,30179,0.8237847509857849,179,58460,0.7002052685596989,2023
157,618,66093,24925,41168,298,88639,0.7456424373018649,64,30179,0.8259054309287915,234,58460,0.7042080054738282,2023
158,617,66379,24997,41382,286,88639,0.7488690079987365,72,30179,0.8282911958646741,214,58460,0.7078686281217926,2023
159,616,66647,25070,41577,268,88639,0.7518925078125881,73,30179,0.8307100964246662,195,58460,0.7112042422169005,2023
160,615,66895,25125,41770,248,88639,0.7546903733119733,55,30179,0.8325325557506875,193,58460,0.7145056448853917,2023
161,614,67179,25200,41979,284,88639,0.7578943805773982,75,30179,0.8350177275588986,209,58460,0.7180807389668149,2023
162,613,67427,25270,42157,248,88639,0.7606922460767833,70,30179,0.8373372212465622,178,58460,0.7211255559356825,2023
163,612,67696,25330,42366,269,88639,0.7637270276063584,60,30179,0.839325358693131,209,58460,0.7247006500171057,2023
164,611,67972,25393,42579,276,88639,0.7668407811459966,63,30179,0.8414129030120282,213,58460,0.7283441669517619,2023
165,610,68222,25442,42780,250,88639,0.7696612100768285,49,30179,0.8430365485933927,201,58460,0.7317824153267192,2023
166,609,68501,25515,42986,279,88639,0.7728088087636368,73,30179,0.8454554491533848,206,58460,0.7353061922682176,2023
167,608,68732,25570,43162,231,88639,0.7754148850957253,55,30179,0.8472779084794062,176,58460,0.7383167978104687,2023
168,607,68969,25633,43336,237,88639,0.7780886517221539,63,30179,0.8493654527983034,174,58460,0.7412931919261033,2023
169,606,69229,25705,43524,260,88639,0.781021897810219,72,30179,0.851751217734186,188,58460,0.7445090660280533,2023
170,605,69499,25781,43718,270,88639,0.7840679610555173,76,30179,0.8542695251665066,194,58460,0.7478275744098529,2023
171,604,69745,25836,43909,246,88639,0.7868432631234558,55,30179,0.8560919844925279,191,58460,0.7510947656517277,2023
172,603,69995,25891,44104,250,88639,0.7896636920542877,55,30179,0.8579144438185493,195,58460,0.7544303797468355,2023
173,602,70248,25948,44300,253,88639,0.7925179661322894,57,30179,0.8598031743927896,196,58460,0.7577830995552515,2023
174,601,70505,26010,44495,257,88639,0.7954173670731844,62,30179,0.8618575830875774,195,58460,0.7611187136503592,2023
175,600,70716,26058,44658,211,88639,0.7977978090908066,48,30179,0.8634480930448325,163,58460,0.7639069449196031,2023
176,599,70956,26117,44839,240,88639,0.800505420864405,59,30179,0.8654030948672918,181,58460,0.7670030790283955,2023
177,598,71211,26176,45035,255,88639,0.8033822583738535,59,30179,0.8673580966897512,196,58460,0.7703557988368115,2023
178,597,71439,26223,45216,228,88639,0.8059544895587721,47,30179,0.8689154710228967,181,58460,0.7734519329456039,2023
179,596,71688,26291,45397,249,88639,0.8087636367738805,68,30179,0.8711686934623414,181,58460,0.7765480670543962,2023
180,595,71897,26342,45555,209,88639,0.811121515360056,51,30179,0.8728586102919248,158,58460,0.7792507697570988,2023
181,594,72131,26390,45741,234,88639,0.8137614368393146,48,30179,0.8744491202491799,186,58460,0.7824324324324324,2023
182,593,72336,26447,45889,205,88639,0.8160741885625966,57,30179,0.8763378508234203,148,58460,0.7849640780020527,2023
183,592,72587,26505,46082,251,88639,0.8189058992091517,58,30179,0.8782597170217701,193,58460,0.7882654806705439,2023
184,591,72807,26553,46254,220,88639,0.8213878766682837,48,30179,0.8798502269790252,172,58460,0.791207663359562,2023
185,590,73044,26613,46431,237,88639,0.8240616432947122,60,30179,0.8818383644255939,177,58460,0.7942353746151215,2023
186,589,73272,26667,46605,228,88639,0.8266338744796309,54,30179,0.8836276881275059,174,58460,0.797211768730756,2023
187,588,73504,26721,46783,232,88639,0.8292512325274428,54,30179,0.8854170118294178,178,58460,0.8002565856996237,2023
188,587,73751,26776,46975,247,88639,0.8320378163111046,55,30179,0.8872394711554392,192,58460,0.8035408826548067,2023
189,586,73970,26825,47145,219,88639,0.8345085120545133,49,30179,0.8888631167368037,170,58460,0.8064488539172083,2023
190,585,74179,26867,47312,209,88639,0.8368663906406887,42,30179,0.8902548129494019,167,58460,0.8093055080396853,2023
191,584,74394,26927,47467,215,88639,0.839291959521204,60,30179,0.8922429503959707,155,58460,0.8119568936024633,2023
192,583,74622,26976,47646,228,88639,0.8418641907061226,49,30179,0.8938665959773352,179,58460,0.8150188162846391,2023
193,582,74838,27032,47806,216,88639,0.8443010413023613,56,30179,0.8957221909274661,160,58460,0.8177557304139582,2023
194,581,75040,27080,47960,202,88639,0.8465799478784733,48,30179,0.8973127008847211,154,58460,0.820390010263428,2023
195,580,75268,27144,48124,228,88639,0.8491521790633919,64,30179,0.8994333808277278,164,58460,0.8231953472459802,2023
196,579,75472,27192,48280,204,88639,0.8514536490709507,48,30179,0.9010238907849829,156,58460,0.8258638385220664,2023
197,578,75670,27237,48433,198,88639,0.8536874287841695,45,30179,0.9025149938699095,153,58460,0.8284810126582278,2023
198,577,75864,27284,48580,194,88639,0.855876081634495,47,30179,0.9040723682030551,147,58460,0.8309955525145398,2023
199,576,76054,27323,48731,190,88639,0.8580196076219272,39,30179,0.9053646575433248,151,58460,0.8335785152240849,2023
200,575,76253,27370,48883,199,88639,0.8602646690508693,47,30179,0.9069220318764704,152,58460,0.8361785836469381,2023
201,574,76450,27406,49044,197,88639,0.8624871670483647,36,30179,0.9081149143444117,161,58460,0.8389326034895656,2023
202,573,76655,27446,49209,205,88639,0.8647999187716467,40,30179,0.9094403393087909,165,58460,0.841755046185426,2023
203,572,76842,27485,49357,187,88639,0.8669095996119089,39,30179,0.9107326286490606,148,58460,0.8442866917550462,2023
204,571,77048,27536,49512,206,88639,0.8692336330509144,51,30179,0.9124225454786441,155,58460,0.8469380773178241,2023
205,570,77246,27584,49662,198,88639,0.8714674127641332,48,30179,0.9140130554358992,150,58460,0.8495039343140609,2023
206,569,77433,27625,49808,187,88639,0.8735770936043954,41,30179,0.9153716160243878,146,58460,0.8520013684570646,2023
207,568,77632,27666,49966,199,88639,0.8758221550333375,41,30179,0.9167301766128765,158,58460,0.8547040711597673,2023
208,567,77833,27716,50117,201,88639,0.8780897798937263,50,30179,0.9183869578183506,151,58460,0.8572870338693124,2023
209,566,78014,27752,50262,181,88639,0.8801317704396484,36,30179,0.9195798402862918,145,58460,0.8597673622990079,2023
210,565,78199,27798,50401,185,88639,0.882218887848464,46,30179,0.9211040789953279,139,58460,0.8621450564488539,2023
211,564,78380,27835,50545,181,88639,0.8842608783943862,37,30179,0.9223300970873787,144,58460,0.8646082791652412,2023
212,563,78574,27879,50695,194,88639,0.8864495312447117,44,30179,0.9237880645481957,150,58460,0.867174136161478,2023
213,562,78754,27920,50834,180,88639,0.8884802400749106,41,30179,0.9251466251366844,139,58460,0.869551830311324,2023
214,561,78958,27959,50999,204,88639,0.8907817100824693,39,30179,0.9264389144769541,165,58460,0.8723742730071844,2023
215,560,79120,28003,51117,162,88639,0.8926093480296483,44,30179,0.9278968819377713,118,58460,0.8743927471775573,2023
216,559,79291,28045,51246,171,88639,0.8945385214183373,42,30179,0.9292885781503695,129,58460,0.8765993841943209,2023
217,558,79454,28083,51371,163,88639,0.8963774410812396,38,30179,0.9305477318665297,125,58460,0.8787375983578515,2023
218,557,79630,28120,51510,176,88639,0.8983630230485452,37,30179,0.9317737499585804,139,58460,0.8811152925076976,2023
219,556,79819,28170,51649,189,88639,0.9004952673202541,50,30179,0.9334305311640545,139,58460,0.8834929866575436,2023
220,555,80005,28213,51792,186,88639,0.9025936664447929,43,30179,0.9348553630007621,143,58460,0.8859391036606227,2023
221,554,80169,28264,51905,164,88639,0.9044438678234186,51,30179,0.9365452798303456,113,58460,0.8878720492644543,2023
222,553,80366,28304,52062,197,88639,0.9066663658209141,40,30179,0.9378707047947248,157,58460,0.8905576462538488,2023
223,552,80553,28342,52211,187,88639,0.9087760466611763,38,30179,0.939129858510885,149,58460,0.8931063975367772,2023
224,551,80740,28382,52358,187,88639,0.9108857275014384,40,30179,0.9404552834752643,147,58460,0.8956209373930893,2023
225,550,80903,28419,52484,163,88639,0.9127246471643408,37,30179,0.941681301567315,126,58460,0.8977762572699282,2023
226,549,81083,28451,52632,180,88639,0.9147553559945396,32,30179,0.9427416415388183,148,58460,0.9003079028395484,2023
227,548,81250,28494,52756,167,88639,0.9166394025203353,43,30179,0.9441664733755261,124,58460,0.9024290112897708,2023
228,547,81418,28533,52885,168,88639,0.9185347307618542,39,30179,0.9454587627157958,129,58460,0.9046356483065344,2023
229,546,81592,28566,53026,174,88639,0.9204977492977132,33,30179,0.9465522383114086,141,58460,0.907047553882997,2023
230,545,81742,28600,53142,150,88639,0.9221900066562123,34,30179,0.9476788495311309,116,58460,0.9090318166267534,2023
231,544,81915,28643,53272,173,88639,0.9241417434763479,43,30179,0.9491036813678385,130,58460,0.9112555593568252,2023
232,543,82062,28673,53389,147,88639,0.9258001556876769,30,30179,0.950097750091123,117,58460,0.9132569278138898,2023
233,542,82224,28718,53506,162,88639,0.927627793634856,45,30179,0.9515888531760496,117,58460,0.9152582962709545,2023
234,541,82381,28755,53626,157,88639,0.9293990230034184,37,30179,0.9528148712681004,120,58460,0.9173109818679439,2023
235,540,82534,28797,53737,153,88639,0.9311251255090874,42,30179,0.9542065674806985,111,58460,0.9192097160451591,2023
236,539,82697,28840,53857,163,88639,0.9329640451719897,43,30179,0.9556313993174061,120,58460,0.9212624016421485,2023
237,538,82897,28883,54014,200,88639,0.9352203883166552,43,30179,0.9570562311541138,157,58460,0.923947998631543,2023
238,537,83064,28929,54135,167,88639,0.9371044348424509,46,30179,0.9585804698631498,121,58460,0.9260177899418406,2023
239,536,83223,28968,54255,159,88639,0.9388982276424599,39,30179,0.9598727592034196,120,58460,0.9280704755388299,2023
240,535,83396,29009,54387,173,88639,0.9408499644625955,41,30179,0.9612313197919082,132,58460,0.9303284296955183,2023
241,534,83554,29043,54511,158,88639,0.9426324755468811,34,30179,0.9623579310116306,124,58460,0.9324495381457407,2023
242,533,83732,29082,54650,178,88639,0.9446406209456334,39,30179,0.9636502203519003,139,58460,0.9348272322955867,2023
243,532,83882,29121,54761,150,88639,0.9463328783041325,39,30179,0.9649425096921701,111,58460,0.9367259664728019,2023
244,531,84033,29159,54874,151,88639,0.9480364173783549,38,30179,0.9662016634083302,113,58460,0.9386589120766335,2023
245,530,84198,29202,54996,165,88639,0.9498979004727038,43,30179,0.967626495245038,122,58460,0.9407458091002395,2023
246,529,84348,29235,55113,150,88639,0.9515901578312029,33,30179,0.9687199708406508,117,58460,0.9427471775573042,2023
247,528,84506,29270,55236,158,88639,0.9533726689154887,35,30179,0.9698797176844826,123,58460,0.9448511802942182,2023
248,527,84634,29298,55336,128,88639,0.9548167285280745,28,30179,0.970807515159548,100,58460,0.9465617516250427,2023
249,526,84799,29337,55462,165,88639,0.9566782116224235,39,30179,0.9720998044998177,126,58460,0.9487170715018817,2023
250,525,84945,29369,55576,146,88639,0.9583253421180293,32,30179,0.9731601444713212,114,58460,0.9506671228190215,2023
251,524,85086,29400,55686,141,88639,0.9599160640350184,31,30179,0.974187348818715,110,58460,0.9525487512829285,2023
252,523,85229,29426,55803,143,88639,0.9615293493834542,26,30179,0.9750488750455615,117,58460,0.9545501197399932,2023
253,522,85388,29459,55929,159,88639,0.9633231421834633,33,30179,0.9761423506411743,126,58460,0.9567054396168321,2023
254,521,85564,29499,56065,176,88639,0.9653087241507688,40,30179,0.9774677756055535,136,58460,0.9590318166267533,2023
255,520,85727,29531,56196,163,88639,0.9671476438136711,32,30179,0.9785281155770569,131,58460,0.9612726650701334,2023
256,519,85873,29566,56307,146,88639,0.968794774309277,35,30179,0.9796878624208887,111,58460,0.9631713992473486,2023
257,518,86008,29590,56418,135,88639,0.9703178059319262,24,30179,0.9804831173995162,111,58460,0.9650701334245638,2023
258,517,86159,29621,56538,151,88639,0.9720213450061486,31,30179,0.9815103217469101,120,58460,0.9671228190215532,2023
259,516,86317,29658,56659,158,88639,0.9738038560904342,37,30179,0.9827363398389609,121,58460,0.9691926103318509,2023
260,515,86458,29693,56765,141,88639,0.9753945780074234,35,30179,0.9838960866827927,106,58460,0.9710058159425248,2023
261,514,86595,29719,56876,137,88639,0.9769401730615191,26,30179,0.9847576129096391,111,58460,0.97290455011974,2023
262,513,86728,29754,56974,133,88639,0.9784406412527217,35,30179,0.985917359753471,98,58460,0.974580910023948,2023
263,512,86869,29790,57079,141,88639,0.9800313631697108,36,30179,0.9871102422214122,105,58460,0.9763770099213137,2023
264,511,87006,29827,57179,137,88639,0.9815769582238066,37,30179,0.988336260313463,100,58460,0.9780875812521382,2023
265,510,87160,29864,57296,154,88639,0.9833143424451991,37,30179,0.9895622784055138,117,58460,0.9800889497092029,2023
266,509,87282,29898,57384,122,88639,0.984690711763445,34,30179,0.990688889625236,88,58460,0.9815942524803284,2023
267,508,87435,29933,57502,153,88639,0.9864168142691141,35,30179,0.9918486364690678,118,58460,0.9836127266507013,2023
268,507,87595,29956,57639,160,88639,0.9882218887848464,23,30179,0.9926107558235859,137,58460,0.9859562093739309,2023
269,506,87753,29989,57764,158,88639,0.9900043998691321,33,30179,0.9937042314191988,125,58460,0.9880944235374615,2023
270,505,87886,30027,57859,133,88639,0.9915048680603347,38,30179,0.994963385135359,95,58460,0.9897194663017448,2023
271,504,88045,30064,57981,159,88639,0.9932986608603437,37,30179,0.9961894032274098,122,58460,0.9918063633253507,2023
272,503,88184,30086,58098,139,88639,0.9948668193458862,22,30179,0.9969183869578183,117,58460,0.9938077317824153,2023
273,502,88343,30112,58231,159,88639,0.9966606121458952,26,30179,0.9977799131846649,133,58460,0.9960827916524119,2023
274,501,88507,30147,58360,164,88639,0.9985108135245208,35,30179,0.9989396600284967,129,58460,0.9982894286691755,2023
275,500,88639,30179,58460,132,88639,1.0,32,30179,1.0,100,58460,1.0,2023
